111111111111111111111111111111111
100010001000100010001000100010001
101010101010101010101010101010101
101000101010001010100010101000101
101111101011111010111110101111101
100010001000100010001000100010001
111010111110101111101011111010111
100010000000100010001000000010001
101111111111111010111111111111101
101000001000001010100000100000101
101011101011101010101110101110101
100010001000100010001000100010001
111110111110111111111011111011111
100010001000100010001000100010001
101011101011101010101110101110101
101000001000001000100000100000101
101111111111111111111111111111101
100010000010000010000010000010001
111010111010111010111010111010111
100010001000100010001000100010001
101111101111101111101111101111101
101000101000100010001000101000101
101010101010111010111010101010101
100010001010000010000010100010001
111111111011111111111110111111111
100010001010000010000010100010001
101010101010111010111010101010101
101000101000100010001000101000101
101111101111101111101111101111101
100010001000100010001000100010001
111010111010111010111010111010111
1E00100000100000100000100000100P1
111111111111111111111111111111111